ST0
[100,300,200,380,300,200,600,200,640,200,800,300,1000,300,1200,160,1200,50,1600,500,1850,400,2000,250,2300,250,2340,250,2380,250,2420,250,2460,250,2500,250],
[200,380,350,300,650,400,900,300,1200,300,1500,290,1800,280,1800,200,1800,100,1800,0,2100,200,2140,200,2180,200],
[200,380,550,480,600,340,550,180,850,180,1150,180,1500,500,1900,400,2150,300],
[200,380,500,420,600,320,500,220,700,120,700,-10,1100,350,1200,200,1400,150,1500,190,1540,150,1580,150,1620,150,1660,150,1700,150,1700,0,2100,500],
[200,380,500,380,800,310,650,100,950,150,350,50,310,50,270,50,230,50,190,50,150,50,110,50,70,50,30,50,-10,50,-450,500,-600,300,-850,200,-1500,200],
[200,380,600,500,600,250,880,375,880,125,1300,500,1650,500],
[200,380,-200,500,-400,325,-200,150,100,50,140,50,180,50,220,50,260,50,300,50,750,500,900,375,1000,250,1300,200],
[200,300,200,100,500,50,750,50,1000,100,1000,0,1400,300,1600,518,1900,518,2000,350,1960,200,2000,200,2040,200,2400,210,2770,250,2800,100,2800,101,2800,102,2800,103,2800,104,2800,105,2900,500,3200,350],
[200,380,-200,518,-300,350,-900,518,-600,350,-1000,350],
[200,380,500,320,800,200,600,100,1100,500,1300,350,1300,250,1300,200,1600,0,1600,70,2000,50,2000,120],
[200,380,500,360,600,200,450,-30,400,-170,100,-170,0,-320,300,-450,600,-450,650,-600,400,-700,400,-900,360,-900,100,-900,200,-1100,200,-1300],
[200,380,500,300,200,280,500,200,400,0,300,-200,-10,-160,-10,-300,100,-500,0,-700,40,-900,340,-900,640,-1100,340,-1200,40,-1200,40,-1400],
[200,380,500,300,600,100,700,-100,400,-100,100,-200,300,-400,710,-350,710,-575,710,-800,400,-850,20,-750,20,-1000,20,-1200,300,-1200,600,-1200,600,-1400,500,-1500,500,-1700,200,-1700,0,-1900],
[200,380,500,300,710,200,600,0,400,-100,100,-100,20,-250,100,-400,400,-400,700,-400,650,-600,400,-700,150,-800,0,-1000,0,-1100,200,-1120,400,-1140,600,-1160,700,-1300,700,-1400,700,-1500,700,-1600,700,-1700,700,-1800,700,-1900,700,-2000],
[200,300,600,300,700,200,700,0,400,-150,0,-100,0,-300,0,-400,350,-500,700,-600,500,-800,700,-1000,500,-1200,225,-1000,25,-1200,25,-1340,400,-1400,700,-1400,700,-1600,700,-1800,300,-1700,0,-1900,200,-2100],
[200,380,0,140,0,-100,300,-100,700,-100,700,-300,700,-500,400,-500,0,-500,0,-700,0,-900,300,-900,700,-900,700,-1100,700,-1300,400,-1300,0,-1300,0,-1500,0,-1700,0,-1900,500,-1500,700,-1700,700,-1900],
[200,380,450,380,700,380,700,200,700,0,500,0,300,0,100,0,0,-200,0,-400,200,-400,400,-400,700,-400,700,-600,700,-800,700,-1000,400,-1000,100,-1000,100,-1200,100,-1400,200,-1600,500,-1600,700,-1600,700,-1800,700,-2000],
[200,380,500,380,350,140,350,-100,0,-200,700,-200,200,-400,500,-400,350,-600,270,-800,350,-800,430,-800,390,-800,310,-800,0,-1000,700,-1000,250,-1150,450,-1150,350,-1150,350,-1400,350,-1600,100,-1700,600,-1700],
[200,380,500,380,700,300,700,100,700,-100,600,-300,500,-500,400,-700],
[200,380,500,180,700,-20,700,-150,400,-300,400,-380,100,-540,100,-620,400,-780,400,-860,0,-860,0,-1100,350,-1100,700,-1100,700,-1300,700,-1500,350,-1500,0,-1500,0,-1700,0,-1900],
[200,380,500,380,800,380,1200,500,1300,400,1500,300,1900,400],
[200,380,520,380,560,380,600,380,800,300,1000,200,1200,100,1600,400,1640,400,1680,400,1900,500,2200,500],
[200,380,250,380,300,380,350,380,400,380,450,380,500,380,550,380,600,380,650,380,700,380,750,380,800,380,850,380,900,380,1000,380,1100,380,1200,380,1300,380,1400,380,1500,380,1600,380,1700,380],
[200,350,500,380,600,380,700,380,800,180,900,180,1300,500,1400,300,1600,500,1800,300,1700,100,1900,200],
[200,380,600,500,900,500,900,300,900,100,1350,500,1600,400,1700,400],
[200,300,500,300,500,100,500,-100,0,-150,0,-400,400,-400,60,0],
[200,300,700,0,0,-300,700,-600,350,-1350],
[],
[200,300,0,50,50,-200,350,-150,700,-200,700,-450,550,-700,300,-650,0,-720,0,-920,350,-1000,700,-1100,700,-1350,700,-1600,700,-1800,250,-1500,0,-1500,50,-1750,100,-2000],
[200,300,225,300,250,300,275,300,300,300,325,300,350,300,375,300,400,300,425,300,450,300,475,300,500,300,525,300,550,300,575,300,600,300,625,300,650,300,675,300,700,300,725,300,750,300,775,300,800,300,825,300,850,300,875,300,900,300,925,300,950,300,975,300],
[200,170],
ST1
[2420,500],
[2480,200],
[2500,500],
[2700,300],
[-1800,200],
[2000,500],
[2500,500],
[3500,200],
[-1000,200],
[2300,300],
[300,-1500],
[200,-1600],
[150,-2100],
[600,-2200],
[350,-2300],
[500,-2200],
[450,-2100],
[350,-1800],
[0,-300],
[300,-2000],
[2250,500],
[2500,500],
[2100,500],
[2300,500],
[2000,300],
[300,-500],
[350,-1500],
[350,-1700],
[150,-2200],
[1000,250],
[-100,-100],
ST2
'first steps',
'with more distance',
'transportion',
'faster transportion',
'reversed',
'further jumps',
'catch up',
'roll over and jump',
'a short stage',
'top wall jump',
'speedrun',
'traps',
'ladders',
'against the time',
'large jumps',
'the correct side',
'almost invisitable',
'invisitable',
'leap of faith',
'combination',
'falling ground',
'short platform',
'dash',
'chaos',
'what',
'tower',
'floor is rolling',
'everything is moving',
'faster pls',
'a small rest',
'fin',
ST3
[255,255,255],
[0,100,255],
[0,100,250],
[167,196,185],
[255,255,255],
[0,243,70],
[50,170,170],
[100,100,100],
[56,78,197],
[0,255,0],
[255,255,0],
[0,255,100],
[255,100,100],
[255,255,255],
[50,100,255],
[255,255,255],
[40,40,40],
[20,20,20],
[200,0,255],
[0,20,0],
[255,255,255],
[10,100,100],
[120,10,50],
[100,100,100],
[100,200,200],
[200,100,200],
[0,255,50],
[255,255,255],
[200,175,125],
[200,200,200],
[0,0,0],
ST4
1,
1,
1,
1,
1,
1,
1,
1,
1,
1,
2,
2,
2,
2,
2,
2,
2,
2,
2,
2,
3,
3,
3,
3,
3,
4,
4,
4,
4,
1,
10000000,*
ST5
None,
None,
[[1500,460,3,300]],
[[2100,400,6,400]],
[[-1250,200,4,200]],
None,
[[1400,100,8,800]],
None,
None,
None,
None,
None,
None,
None,
None,
None,
None,
None,
None,
None,
None,
None,
None,
None,
None,
None,
[[0,150,5,700],[700,-150,-7,-700],[0,-450,9,700],[700,-700,-2,-200],[100,-950,2,200],[0,-1200,5,700]],
[[200,400,1,10000],[200,300,5,500],[0,50,5,700],[0,-100,7,700],[700,-300,-7,-700],[0,-500,10,350],[350,-700,10,350],[700,-950,-3,-700],[700,-1200,-6,-700],[700,-1450,-8,-700]],
None,
None,
[[200,200,0,0],[200,200,0,0],[200,200,0,0]],*